###############
#@............#
#.####.####...#
#......##.....#
###.##.##.##..#
#.....##......#
#.###########.#
#.............#
#######.#######
###############
