########
#@.....#
#.####.#
#......#
######.#
