############
#@......#..#
#.####..#..#
#..##...#..#
#...##...#.#
#....##....#
#.########.#
#..........#
#######.####
